10 10
1111111111
1001000101
1001000101
1000011001
1011100001
1000100001
1010001001
1011101101
1100000001
1111111111